{
"spawn_player_x":"920",
"spawn_player_y":"1110",
    "monster_1": [500,300,1,1000],
    "monster_2": [100,425,2,1000],
    "monster_3": [900,590,1,1000],
    "monster_4": [900,340,2,1000],
    "monster_5": [900,460,1,1000],
    "monster_6": [900,500,2,1000],
    "monster_7": [500,900,7,1000],
    "monster_8": [700,900,7,1000],
    "monster_9": [900,900,7,1000],

"level": [
    "-                                -",
    "-   *       *    *  *   **   *   -",
    "-     *   *  * *    *   * *  *   -",
    "-       **    *     *   *   **   -",
    "-                                -",
    "-                                -",
    "-                                -",
    "-------------------------      ---",
    "- ********                       -",
    "-  ******                        -",
    "-    **                          -",
    "-                              ---",
    "-                                -",
    "-               --               -",
    "-                                -",
    "-                       --       -",
    "*                                -",
    "*            ---                 -",
    "---                              -",
    "-                               *-",
    "-                              **-",
    "-                              **-",
    "-                              **-",
    "---                            **-",
    "-                               *-",
    "-                               *-",
    "-                                -",
    "-        --                      -",
    "-                                -",
    "-                                -",
    "-                  -----         -",
    "-                  *****         -",
    "-    *              ***          -",
    "-   ****     ---     *           -",
    "-  *******                       -",
    "- **********                     -",
    "----------------------------------"]
}
